1 2 3 4 3 2
3 0 0 0 0 1
2 0 4 1 0 2
1 0 2 3 0 3
2 0 0 0 0 4
3 4 3 1 2 3