1 2 3 1 2 3 1 2 3 1 2 3 1 2 3 1 
4 0 0 0 0 0 1 4 0 0 0 0 0 0 0 1 
1 0 4 2 3 0 4 1 0 1 1 0 1 4 0 4 
4 0 4 0 0 0 0 0 0 0 1 0 1 1 0 1 
1 0 4 0 1 0 0 0 0 0 0 0 1 0 0 4 
1 0 1 0 1 2 3 0 0 1 1 0 0 0 0 1 
4 0 1 0 0 0 0 0 0 4 2 3 4 0 0 4 
4 0 0 0 4 0 0 4 4 0 0 0 4 4 0 4 
1 0 4 0 0 0 0 0 0 0 0 0 1 0 0 1 
4 0 1 0 0 0 0 1 4 0 0 0 1 0 0 1 
4 0 1 0 0 1 0 0 0 4 0 1 2 3 0 4 
4 0 4 0 0 0 1 1 0 0 0 0 0 1 0 4 
4 0 1 0 0 0 0 0 0 0 0 1 0 1 0 4 
1 0 1 1 0 1 0 0 0 0 0 1 0 0 0 1 
1 0 0 0 0 1 0 0 0 0 0 0 0 0 1 1 
1 2 3 1 2 3 1 2 3 1 2 3 1 2 3 1